GGGGtTtGGGPPPGGtTtGGGGGPPPGGtTtG
GGtTtGGGGGPPPGGGGGtTtGGGPPPGGGGG
GtTtGGPPPGGGGGGGtTtGGGGGPPPGGtGG
GGGGGPPPGGGGGGGGGGGGtTtGGPPPGGGG
GGGGGGGGGpppppppppppppGGGGGGGGGG
GGGPPPGGGpGGGGGGGGGGpGGGPPPGGGGG
GGGGGGGGGpGGtTtGGGGGpGGGGGGGGGGG
GtTtGGGGGpGGGGGGGGGGpGGGtTtGGGGG
GGGGGGGGGppppppp+pppppGGGGGGGGGG
GGGPPPGGGGGGGGGGpGGGGGGGGPPPGGGG
GGGGGGGGGGGtTtGGpGGtTtGGGGGGGGGG
GGtTtGGGGGGGGGGGpGGGGGGGGtTtGGGG
GGGGGGGGGGGGGGGGpGGGGGGGGGGGGGGG
GGGGGPPPGGGGGGGGpGGGGGGGPPPGGGGG
GGGGGGGGGpppppppppppppGGGGGGGGGG
GGtTtGGGGpGGGGGGGGGGpGGGGtTtGGGG
GGGGGGGGGpGGGPPPGGGGpGGGGGGGGGGG
GGGGGGGGGpGGGGGGGGGGpGGGGGGGGGGG
GGGPPPGGGpGGtTtGGGGGpGGGPPPGGGGG
GGGGGGGGGpGGGGGGGGGGpGGGGGGGGGGG
GGGGGGGGGpppppppppppppGGGGGGGGGG
GGtTtGGGGGGGGGGGGGGGGGGGGtTtGGGG
GGGGGGGGGGGGPPPGGPPPGGGGGGGGGGGG
GGGGGGGGGGGGGGGGGGGGGGGGGGGGGGGG
