GGGGtTtGGGFfFGGtTtGGGGGFfFGGtTtG
GGtTtGGGGGFfFGGGGGtTtGGGFfFGGGGG
GtTtGGFfFGGGGGGGtTtGGGGGFfFGGtGG
GGGGGFfFGGGGGGGGGGGGtTtGGFfFGGGG
GGGGGGGGGpppppppppppppGGGGGGGGGG
GGGFfFGGGpGGGGGGGGGGpGGGFfFGGGGG
GGGGGGGGGpGGtTtGGGGGpGGGGGGGGGGG
GtTtGGGGGpGGGGGGGGGGpGGGtTtGGGGG
GGGGGGGGGppppppp+pppppGGGGGGGGGG
GGGFfFGGGGGGGGGGpGGGGGGGGFfFGGGG
GGGGGGGGGGGtTtGGpGGtTtGGGGGGGGGG
GGtTtGGGGGGGGGGGpGGGGGGGGtTtGGGG
GGGGGGGGGGGGGGGGpGGGGGGGGGGGGGGG
GGGGGFfFGGGGGGGGpGGGGGGGFfFGGGGG
GGGGGGGGGpppppppppppppGGGGGGGGGG
GGtTtGGGGpGGGGGGGGGGpGGGGtTtGGGG
GGGGGGGGGpGGGFfFGGGGpGGGGGGGGGGG
GGGGGGGGGpGGGGGGGGGGpGGGGGGGGGGG
GGGFfFGGGpGGtTtGGGGGpGGGFfFGGGGG
GGGGGGGGGpGGGGGGGGGGpGGGGGGGGGGG
GGGGGGGGGpppppppppppppGGGGGGGGGG
GGtTtGGGGGGGGGGGGGGGGGGGGtTtGGGG
GGGGGGGGGGGGFfFGGFfFGGGGGGGGGGGG
GGGGGGGGGGGGGGGGGGGGGGGGGGGGGGGG
