GGGGtTtGGGFfFGGtTtGGGGGFfFGGtTtG
GGtTtGGGGGFfFGGGGGtTtGGGPpPGGGGG
GtTtGGGpGGGGGGGGtTtGGGGGFfFGGtGG
GGGGGFfFGGGGGGGGGGGGtTtGGFfFGGGG
GGGGGGGGGpppppppppppppGGGGGGGGGG
GGGFfFGGGpGGGGGGGGGGpGGGFfFGGGGG
GGGGGGGGGpGGtTtGGGGGpGGGGGGGGGGG
GtTtGGGGGpGGGGGGGGGGpGGGtTtGGGGG
GGGGGGGGGppppppp+pppppGGGGGGGGGG
GGGFfFGGGGGGGGGGpGGGGGGGGGfPGGGG
GGGGGGGGGGGtTtGGpGGtTtGGGGGGGGGG
GGtTtGGGGGGGGGGGpGGGGGGGGtTtGGGG
GGGGGGGGGGGGGGGGpGGGGGGGGGGGGGGG
GGGGGFfFGGGGGGGGpGGGGGGGFpGGGGGG
GGGGGGGGGpppppppppppppGGGGGGGGGG
GGtTtGGGGpGGGGGGGGGGpGGGGtTtGGGG
GGGGGGGGGpGGGGfpGGGGpGGGGGGGGGGG
GGGGGGGGGpGGGGGGGGGGpGGGGGGGGGGG
GGGFfFGGGpGGtTtGGGGGpGGGFfFGGGGG
GGGGGGGGGpGGGGGGGGGGpGGGGGGGGGGG
GGGGGGGGGpppppppppppppGGGGGGGGGG
GGtTtGGGGGGGGGGGGGGGGGGGGtTtGGGG
GGGGGGGGGGGGGPFGGGGGGGGGGGGGGGGG
GGGGGGGGGGGGGGGGGGGGGGGGGGGGGGGG
